+++++++++++++++++++++++
+       +   +     +   +
+ +++++   +   +++ + + +
+      ++ +++++   + +  
+++ ++++++    +++    ++
+          ++  +++   ++
+++++++ +++       + ++ 
+     +   +++++++  + ++
+ +++++++     +S +    +
+           +    + + ++
++++++++++++++++ ++++++
